GGGGGGGGGGGGGGGGGGGGGGGGRGGGGRGGGGGGGGGGGGGGRGGGGRGGGGGGGGGGGGGGGGGGGGGGGGGWTGGRGGGGTTGGGRGGGGGGWGGG
TWGGGGGGGGGGGWGGRGGGGGGTTGGGGGGGWWWGGGGGGGGGGGGGGGGGGGGGWWGGGGGGGGGGWGTGGGGGTGGGGGGGGGGGGGGGGGGGGGGG
TGGGGGGGGGTTGWGGRGRGGGGGGGGGGGGGWGRGGGGRWGGGGGWWWGGGGGRGWWGGGGGGGGGGGGGTGGGGTGWGGGGGRGGGGGGGGGGGGWGG
GGGWTGGGGGGGGGRGGGGRGTTGGGGGGGGTTGGGGGGGWWTGGGTGGGGGGGGGTGGRGGGGRWGGGGGGTGGGGGGGGGGGTTGGGGGGTGRGGGWG
GGGTRGGGGRGGGGGRRGGGGGGGGGGGGGGGGGGGGGGGWGGGGGGGGGGGGGGGTGGGGGGGTTTGGRRGGGRGGGGGGGGGGGGGGGGGTGGGTGGG
GGGGGGGGGGGGGGGGGGGGGGGGGGGGGGGGGGGGGGGGGGGGGGGGGGGGGGGGGGGGGGGGGGGGGGGGGGGGGGGGGGGGGGGGGGGTGGGGGGGR
GGGGGGWGGGGGGGGWGGGGGGGGGGGGGGGGGGGGGGGGGGGGGGGGGGGGGGGGGGGDGGGGGGGGGGGGGGGGGGGGGGGGGTTTGGTGGGGGGGTG
GGGGGGGGGGGGGGGGGGGGGGGGGGGGGGGGGGGGGGGGGGGGGGGGGGGGGGGGGGGGGGGGGGGGGGGGGGGGGGGGGGGGGGGTGGGTGGGGGTTG
GGGGGGGGWGGGGGGGGWGGGGGGGGGGGGGGGGGGGGGGGGGGGGGGGGGGGGGGGDGGGGDGGGGGGGGGGGGGGGGGGGGGGGGGGGGGTGGGTTGG
GGGGGGGGGRGGGGGGGGRGGGGGGGGGGGGGGGGGGGGGGGGGGGGGGGGGGGGGGGGGGGGGGGGGGGGGGGGGGGGGGGGGGGGGGGGGGGGGGTTG
GGGGGGGGGGGGGGGGGGGGGGGGGGGGGGGGGGGGGGGGGGGGGGGGGTGGGGGGGGGGDGGDGGGGGGGGGGGTGTGGGGGGGGTGGGGGGGTGGGGG
GGGGGGGGWGGGGGGGGGGGGGGGGGGGGGGTWGGGGGGGGGGGGGGGGGGGGGGGDGGGGGGGGGGGGGGGGGGGGGGGGGGGGTGGTGGGGGTGGGTG
GGGGGTTGWGGGGGGGGGGGGGGGGGGGGGGTGGGGGGGGGWGGGGGGGGGTGGGGGGGGGDGGGGDGGGGGGGTGGGGGGTGGTGGGGGGGGGGGGGTG
GGGGGGGGGRGGGGGGGGGGGGGGGGGGGGGGGGWTGGGGGWGGGGGGGGGGGGGGGGDGGGGDGGGGGGGGGGGGGGGGGGGTTGGGGGGGGGGGGGTG
GGGGGGGGGGGGGGGGGGGGGGGGGGGGGGGGGGTRGGGGGGGRGGGGGGGGGTGGGGGDGGGDGGGGGGGGGTGGGGGGGGTTTGGGGGTGGGGGGGTG
GGGGGGGGGGGGGGGGGGGGGGGGGGGGGGGGGGGGGGGGGGGGGGGGGGGGGGGGGGGGDGGGGGGGGGGGGGGGGGGGGGGTGGGGGTGGGGGGGGTT
GGGGGGGGGGGTGGGGTGGGGGGGGGGGGGGGGGGGGGGGGGGWGGGGGGGGGGTWGGGGGDGGGGGGGGGGGGGGGGGGGGGGTGGGTGTGGGGGGGGT
GGGGGGGGGGTGWGGWGTGGGGGGGGGGGGGGGGGGGGGGGGGWGGGGGGGGGGTWGGGGGGGGGGGGGTGGGGGGTTGGGGGGGTGGGTGTGGGGGGGG
GGGGGGGGGTGGWGWGGGTGGGGGTWGGGGGGGGGGGGGGGGGGRGGGGGGGTGGGGRGGGGGGGGGTGGGGGGGGGTTGGGGGGGGGGTGGGGGGGTGG
GGGGGGGGGGGGWWGGGGGGGGGGTGGGGGGGGGGGGGGGGGTGGGGGGGGTGGGGGGGGGGGGGGGGGGGGGGGGGGGTGGGGGGGTTGGGGGTGGGGG
GGGGGGGGGGGGWWGGGGGGGGGGGGGWTGGGGGGGGGGGGGGGGGGGGGTGGGGGGGGGGGGGGTGGGGGTGGGGGGGTGGGGGGGTGGGGGGGGGTGG
GGGGGGGGGTGGWGWGGGTGGGGGGGGTRGGGGGGGGGGGGGGGTGGGGGGGGGGGGGGTGGGGGGGGGGGGGGGGGGGTGGGGGGGGGGGGGGGGGGTG
GGGGGGGGGGTGWGGWGTGGGGGGGGGGGGGGGGGGGTGTGGGGGGGTGTGGGGGGGGGGGGGGGGGGGGGGTGGGGGGTGRWGGGGGGGGGGGTGGTGG
GGGGGGGGGGGTGGGGTGGGGGGGGGGGGGGGGGGGGGGGGGGGGGGGTGGGGGGGGGGGGGGTGGGGGGGGGGTGGGGGGTTTGGGGGGGGGGGGGGGG
GGGGGGGGGGGGTWGGGGGGGGGGGGGGGGGGGGGGGGGWGGGGGGGGGGGGGGGGGGGGGTTGGGGGGGGGGGGGGGGGGGGGGGGGGGGGGGGTTGTG
GWGGGGGGGGGGTGGGGGGGGGGGGGGGGGGGWWWGGGGWGGGGGGGGWGGGGGGGGGGGGGGGGGGGGGGGGGTTGGGGGGGTTGGGGGGGGGGGTGGG
GGGGGGGGGGGGGGGWTGGGGGGGGGGGGGGGWGRGGGGGGRGGGGGGWGGGGGGGGGGGGGGGGGGGGGGGGGGGGGGGGGGGTTGGGGGGGGTGGGGG
GGGWGGGGGGGGGGGTRGGGGGGGGGGGGGGTTGGGGGGGGGGGGGGGGGRGGGGGGGGGGGGGGGGGGGGGGGGGGGGGTGGGGTGGGGGGGTGGGGGT
GGGGRGGGGGGGGGGGGGGGGGTWGGGGGGGGGGGGGGGGGGGGGGGGGGGGGGGGGGGGGGGGGGRWGGGGGTGGGGGGGTGGGTGTGGGGGGTTGGGG
GGGGGGGGGGGGGGGGGGGGGGTGGGGGGGGGGGGGGGGGGGGGGGGGGGGGGGGGGGGGGGGGGGTTTGGGGGGGGGGGGGTGGGGTGGGGGGGTGGGG
GGGWGGGGTWGGGGGGGGGGGGGGGWTGGGRRRRRRRRRRRRRRRRRGRRRRRRRRRRRRRRRRRRRRRRRGGGGGGGGGGGGGGGGTGGGGGTGGGTGG
TTGWGGGGTGGGGGGGGGGGGGGGGTRGGGLLLLLLLLLLLLLLLLLGLLLLLLLLLLLLLLLLLLLLLLLGGGTGGGGGTTTTGGGGGGGGGTGGGGGG
GGGGRGGGGGGWTGGGGGGGGGGGGGGGGGLLLLLLLLLLLLLLLLLGLLLLLLLLLLLLLLLLLLLLLLLGGGGTGGGGGGGGGGGGGGGGTGGGGTGG
GGGGGGGGGGGTRGGGGGGGGGGGGGGGGGLLLLLLLLLLLLLLLLLGLLLLLLLLLLLLLLLLLLLLLLLGGGGGTGGGGGGGGGGGGGGTGGGTGGGG
GGGGGGGGGGGGGGGGGGGGGGGGGGGGGGLLLLLLLLLLLLLLLLLGLLLLLLLLLLLLLLLLLLLLLLLGGGGGGGGGGGGGGGGGGGTGGGTGGGGG
GGGGGGGGGGGGGGGGGGGGGGGGGGGGGGRRRRRRRRRRRRRRRRRGRRRRRRRRRRRRRRRRRRRRRRRGGGGGGTTGGRWGGGGTGGGGGGGGGGGG
GGGGGGGGGGGGGGGGGGGGGGGGGGGGGGGGGGGGGGGGGGGGGGGGGGGGGGGGGGGGGGGGGGGGGGGGGGTGTGGGGTTTGGGGGGGGGGGGGGGG
GGGGGGGGGGGGGGGGGRWGGGGGGGGGGGGGGGGGGGGGGGGGGGGGGGGGGGGGGGGGGGGGGGGGGGGGGGGGGGGGGGGGGGGGGGTTTTTGGGGG
GGGGGGGGGGGGGGGGGTTTGGGGGGGGGGGGGGGGGGGGGGGGGGGGGGGDWWGGGGGGGGGGGGGGGGGGGGGGGGGGGGGGGGGGGGGGGGGGGGGG
GGGGGGGGGWGGGGGGGGGGTGGGGTGGGGGGGGGGGGGGGGGGGGGGGGGGWWGGDDGGGGGGGGGGGGGGGGGGTGGGGGGGGGGGGGGGGGGGTGGG
GGGGGGGGGWGGGGGGGGGTGWWWWGTGGGGGGGGGGGGGTTGTTTTGTTTTGTTGGGGGGGGDGGGGGGGGGGGGGTGGGGGGGGGGGGGGGGGGTTTG
GGGGGGGGGGGRGGGGGGTGGWGGGGGTGGGGGGGGGGGGTGGGTTGGGGTGGGTGGGGGGGGGGGGGGGGGGGGGGGTTGGGGGGGGGGGRWGGGGTGG
GGGGGGGGGGGGGGGGGGGGGWGGGGGGGGGGGGGGGGGGGGFGGGGFGGGGFGGDGGGGGDGGGGGGGGGGGGGGGGGGGGGGGGGGGGGTTTGGGGGG
GGGGGGWWWGGGGGGGGGGGGWWWWGGGGGWWWGGGGGGGTGGGTGGGGTTGGGTGGGDGGGGGGDGGGGGWGGGGGGGGGGGGGGGGGGGGGGTTGGGG
GGGGGGWGRWGGGGGGGGGGGGGGWGGGGGWGRGGGGGGGTGGGTTTGGGTTGTTDDGDGGGGGGGGDGGGWGGGGGGGGGGTGGGGGGGGGGGGGGGGG
GGGGGTTGGWGGGGGGGGTGGGGGWGGTGTTGGGGGGGGGTGGGGGGGTTTGGTTDDDDDDGDDGGGGGGGGGRGGGGGGGGGTGGGGGGGGGGTGGGGG
GGGGGGGGGGGRGGGGGGGTGWWWWGTGGGGGGGGGGGGGTGGGTGGGGGGGGGTRDDDDDGDDDDGGGGGGGGGGGGGGGGGGGGGGGGGGGGGTGGGG
GGGGGGGGGGGGGGGGGGGGTGGGGTGGGGGGGGGGGGGGGGFGGGGFGGGGFGGDDRDDDDDDGGGGGGGGGGGGGGGGGGGGTTTGGGGGGGGGGGGG
GGGGGGGGGGGGGGGGGGGGGGGGGGGGGGGGGGGGGGGGTGGGTGGGGTGGGGTDDDDDDDDDDGDGGGGGGGGGGGRWGGGGGGGGGGGGGTTGGGGG
GGGGGGGGGGGGGGGGGGGGGGGGGGGGGGRWGGGGGGGGTGGGGTGGGTTTGGTDRRRRDDDDDGGGGRWGGGGGGGTTTGGGGGGGGGGGGGGGGGGG
GGGGGGGGGGGGGGGGGGGGGGGGGGGGGGTTTGGGGGGGTGGGTGGGGGGTGTTDGGGGGGDDGDGGGTTTGGGGGGGGGGGGGGGGGGGGGGGGGGGG
GGGGGGGGGGGRLLLLRGGGGGGGGGGGGGGGGGGGGGGGTGGGTGGGGGTGGGTDGGGGGGDDGGGGGGGGGGWGGGGGGGGGGGGGGGGGGGGGGGGG
GGGGGGGGGGGRLLLLRGGGGGGGGGGGGGGGGGGGGGGGGGFGGGGFGGGGFGGDDDGGGGGDGGGGGGGGGGWGGGGGGGGGGGGGGGGGGGGGGGGG
GGGGGGGGGGGRLLLLRGGGGGGGGGGGGGGGGGGGGGGGTGGGTGGGGGTGGGTDDGDGGGDGGGDGGGGGGGGGRGGGGGGGGGGGGGGGGGGGGGGG
GGGGGGRWGGGRLLLLRGGGGGGGGGGGGGGGGGGGGGGGTTGTTTTGTTTTGTTGGGGGGGGGGGGGWGGGGGGGGGGGGGGGGGGGWGGGGGGGRWGG
GGGGGGTTTGGRLLLLRGGGGGGGGGGGGGGGGGGGGGGGGGGGGDDGDDGGGDGGGGGDDGGGGGGGWGGGGGGGGGGGGGGRWGGGWGGGGGGGTTTG
GGGGGGGGGGGRLLLLRGGGGGGGGGGGGGGGGGDGGGGGGGGDGDGDDDGGGGGGGGGGGGGGGDGGGGRGGGGGGGGGGGGTTTGGGGRGGGGGGGGG
GGGGWWWGGGGGGGGGGGGGGGGGGGGGGGGGGDGGGGGGGGGGGRDDDDGDGGGGGGGGGGGGDGGGGGGGGGGGGGGGGGGGGGGGGGGGGGGGGGGG
GGGGWGRGGGGRLLLLRGGGGGGGGGWWWGGDGGDGGGGGGGGGGDDGGDDGGGGGGGDGGGGGGGGRRRRRRRRRRRRRRRRRRRRRRRRRRRRRRGGG
GGGTTGGGGGGRLLLLRGGTGGGGGGWGRGGGGGGGDWGGGGGDGDDDDDGGGGGGGGGGGGGGGGGLLLLLLLLLLLLLLLLLLLLLLLLLLLLLLGGG
GGGGGGGGGGGRLLLLRGGTGGGGGTTGGGDGGGGGTTTGDGDGGGDDDDGDDGGGGGGGGDGGGGGLLLLLLLLLLLLLLLLLLLLLLLLLLLLLLGGG
GGGGGGGGGGGRLLLLRGGGGGGGGGGGGGGGGGGGGGGGDGGGGDGDDDDGGGGGGGGGGDGGGGGLLLLLLLLLLLLLLLLLLLLLLLLLLLLLLGGG
GGGGGGGGGGGRLLLLRGGGGGGGGGGGGGGGDDGGGDDGGGGGGDDDDDDDGDGGGGGGGGGGGGGLLLLLLLLLLLLLLLLLLLLLLLLLLLLLLGGG
GGGGGGGGGGGRLLLLRGTTGGGGGGGGGGGGDGDDDGGGGGGGGDDDDDGGGDDDDGDGGGGDGGGRRRRRRRRRRRRRRRRRRRRRRRRRRRRRRGGG
GGGGGGGGGGGRLLLLRGGGGTGGGGRWGGGGGGGGGGGGGGGDGGDDRRGGGGDGGDGGGGGGGGGGGGGGGGGGGGTTGGGGGGGGGGGGGTGGGGGG
GGGGGGGGTGGRLLLLRGGGGGTGGGTTTGDGDDDDDDDDDDDDDGDDDDDDDDDDDDDGGRDDDDDDDGDDDDDDDGDDTDDDDDDDGGDDDTTDDGRD
GGGGGGGGGGGRLLLLRGGGGGGGGGGGGGGDDTDDDDGGDGDDGDDDDDDDGDDDDDDGDDRDDDDDDGDDDDDGDRDDDGGDDDRRDDDDDDGGDDRD
GGGGGGGGTGGRLLLLRGGGGGGGGGGGGGGDDDDDDDDDDDGDDDDDDDDGDDDDDGGDDDDDDDRRDRDRRRDDRDDDDDGDDRDRDDDGGDDDDRDD
GGGGGGGGTGGRLLLLRGGGGGGGGGGGGGGDDDDDDDDDDDDDDDDDDDDDDDDDDRDDDDDDRDDGGDDDDDDDDDDDDDDDDRDDRDDDGDGDDDDD
GGGGGGGGGGGRLLLLRGGGWGGGGGGGGGGGGDDGDDTDDDDDDDDDDDDDDDDRDDDDDDDDDDDDDDDDDDDDDDDDGDDDDDDDDDRDDDDDRDTD
GGGGGGGGGTGRLLLLRGGGWGGGGGGGGDGDDDDDDDDDDDDDDDDDDDDDDDDDDDDDDDDDDDDDDDDDDDDDDDDDDDRRDDDDDDDRDDDDDDDD
GGGDDGGGGGTRLLLLRGGGGGRGGGGGGGGDDDGDDDDDDDDRDDDDDDDDDDDDDDRDDDDDDDDDDDDDDRDDDDDDDRRDDDDDDDDDDDDDDDDD
GGGGGGGGGGGRLLLLRGGGGGGGGGGDDGGDDDDDDDDDDDDDRDDDDDDDDRDDDDDDDDDDDDDDRDDDDDRDDDDDDDDDDDDDDDDRDRDDDDDD
GDGGGDGGGGGRLLLLRGGGGGGGGGGGGGDDGDDDDDDDDRDDDDRDDDDRDDDDDDDDRDDDDDDDDDDDDDDDDDDDDDDDDDDDDDDDDDRDDDDD
GGGGGGDGGGGRLLLLRGTGGGGGGGGGGDGDDDDDDDDDDDDDDDDDDDDDDDDDDDDDDRDDDDDDDDDDDDRDDDDDDDDDDDDDDDDRDDDDDDRD
GGGGGGGGGGGGGGGGGGGGGGGGGGGDGGGDDDGDDDDDDDDDDDDDDRDDDDDDDDDDRDDDDDDDDDDDDDDDDDDDDDDDDDDDDDDRDDDDDDRD
GDGGGGGGGGGRLLLLRGGTGGGGGGGDGGGGGDDDDDDDDDDDDDDDDDDDDDDDDDDDDDDDDDDDDRRDDDDDDDDDDDDDDDDDDDDRDDDDDRDD
GGDGGDGGGGGRLLLLRGGGGTGGGGGGDGGDDDDDDRDDDDDDDDDDDDDDDDDDDDRDDDDDDDDDDRRDDDDRDDDDDRDDDDDDDDDDDDDDDDDD
GGTDGGGGGGGRLLLLRGGGGGTGGGGGGDGDGDRDDDDDDDDDDDDDDDDDDDDDDDDDDDDDDDDDDDDDDDDDDDDDDDDDDDDDDDDDDDDDRDDD
GTGGGGGTGGGRLLLLRGGGGGGTGGGGGGGDDDDDRDDDDDDDDDDDDDDDDDRDDDDDDDDDDDDDDDDDDDDDDDDDDDDDDDDDDDDDDDDDDDDD
TGWWWWWGTGGRLLLLRGGGGGGGGGGGGGGGDDDDDDDDDDDDDDDDDDDDDDDDDDDDDDDDDDDDDDDDDDDDRDDDDDDDDDDDDRDDDDDDRDTD
GGGGWGGGGTGRLLLLRGGGGGGGGGGGGDGGDDDDRDDDDDDDDDDDDDDDDDDDDDDRDDRRDDDDDDDDDDDDDRDDDDRDDDDDDDDDDDDDDRDD
GGGGWGGGGGGRLLLLRGGGGGGGGGGDDGGDGDDDDDRDDDDDDDDDDDDDRDDDDDDDDDDDRDDDDDDDDDDDDDDDDDDDDDDRDDDDDDDDDDDD
GGGGWGGGGGGRLLLLRGGGGWGGGGGGGGGDDGTDDDDDDDDDDDDDDDDRDDDDDDDDDDDDDDDDDDDDDDDDDDDDDRDDDDRDDDDDDDDDRDDD
GTGGWGGTGGGGGGGGGGGGGWGGGGGGGGDDGDDDDDDDRDDDDDDDDDDDDDDDDDDDDDDDDDRDDDDDDDDDDDDDRDDDDRDDDDDDDDDRDDDT
GTTGWGTTGGGGGGGGGGGGGGGRGGGGGGDDDDDDDDDDDDDDDDDDDDDDRDDDDDDDDDDDDDDRDDDDDDDDDDDRDDDDRDDDDDDDDDRDDDDD
GGGTGTGGGGGGGGGGGGGGGGGGGGGGGDGDGDDDDDDDRDDDDDDDDDDDDRDRDDDDDDDDDDDDDDDDDDDDDDRDDDDRDDDDDDDDDDDDDDDD
GGGGGGGGGGGGGGGGGGGGGGGGGGGGDGGTDDDDDDDDDDDDDDDDDDDDDDDDDDDDDDDDDDDDRDDDDDDDDRDDDDRDDDDDDDDDDRRDDDDD
GGGGGGGGGRWGGGGGGGGGGGGGGGGGDGGDGDDDDDDDDDRDDDDDDDDDDDDDDDDDDDDDDDDDDDDDDDDDDDDDDRDDDDDDDDDDDDDDDDDD
GGGGGGGGGTTTGGGGGGGGGGGGGGDGGGGGDDDGDDDDDDDDDDDDDDDDDDDDDDDDDDDDDDDDDDDRDDDDDDDDDDDDDDDDDDDDDDDDDDDD
GGGGGGGGGGGGGGGGGGGGGGGGGGGDGGGDDDDGDDDDDDDDDRDDDRDDDDDDDDDDDDDDDDDDDDDDDDRDDDDDDTDDDDDDDDDRDDDDDDTD
GGGGGGRGGGGGGGGGGGGGGGGGGGGGGDGGDDDDDDDDDDDDDDDDDDDDDDDDDDDDDDDDDDDDDDDDDRRDDDDDDDDDDDDDDDDDDDDDRDTD
GGGGGGRGRGGGGGGGGGRWGGGGGGGGGGDDGDGDDDDDDDDDDDDRDDDDDDDDDDDDDDDDDDDDDDDDDDDDDDDDDDDDDDDDDDDDDDDDRDRD
GGGGGGGGGRGGGGGGGGTTTGGGGGGGGDGDGDDDDDDDDDDDDDDDDDDDDDDDDDDDDDDDDTDDDDDDDDDDDDDDDDDRDDDDDDDRDDDDDDDR
GGGGGRRGGGGGGGGGWGGGGGGGGGGGDGGDGDDDDDDDDDDDDDDDDDDDDDDDDDDDDDDDDDDDDDDDDDDDDDDDDDDDDDDDDDDRDDDRRDDD
GGGGGGGGGGGGGGGGWGGGGGGGGGGGDGGGDRDDDDDDDDDDRDDDDDDDDDDDDDDDDDDDDDDDDDDDDDDDDDDDDDDDDDDDDDDDDDDDDDDD
GRGGGGGGGGGGGGGGGGRGGGRWGGGGGGGDGDDDDDDDDDDDDDDDTDDDDDDDDDDDDRRDDDDDDTDDDDDDDDDTDRDDDDDDRDDDDDDDRDDD
GRGRGGGGGGGGGGGGGGGGGGTTTGGGDGGDGGDDDDDDDDRDDDDDDDDDDDDDDDDDDDDRDDDDDDDDDDDDDDDDDDDDRDDDDDDDDDDDRDRD
GGGGRGGGGGGRWGGGGGGGGGGGGGGGGGGDDGDRDRDDRDDDDDDDDDDDDDDDDTDDRDDDRDDDDDDDDDDDDDDDDDDDDDRDDDTTDDDDDDDR
RRGGGGGGGGGTTTGGGGGGGGGGGGGGGGGDDDDDDDDDDDDDDDDDDDDTDDDDDDDDDDDDDDDDDDDDDDDDDDDDDDDDDDDDDDTTDDDRRDDD